,Year,Winner,ScoreW,Loser,ScoreL,Combined
296,1961,PRINCETON,84,GEORGEWASHINGTON,67,151
297,1961,ST.BONAVENTURE,86,RHODEISLAND,76,162
298,1961,WAKEFOREST,97,ST.JOHN'S,74,171
299,1961,LOUISVILLE,76,OHIO,70,146
300,1961,MOREHEADSTATE,71,XAVIER(OHIO),66,137
301,1961,HOUSTON,77,MARQUETTE,61,138
302,1961,ARIZONASTATE,72,SEATTLE,70,142
303,1961,SOUTHERNCALIFORNIA,81,OREGON,79,160
304,1961,ST.JOSEPH'S,72,PRINCETON,67,139
305,1961,WAKEFOREST,78,ST.BONAVENTURE,73,151
306,1961,OHIOSTATE,56,LOUISVILLE,55,111
307,1961,KENTUCKY,71,MOREHEADSTATE,64,135
308,1961,KANSASSTATE,75,HOUSTON,64,139
309,1961,CINCINNATI,78,TEXASTECH,55,133
310,1961,ARIZONASTATE,86,SOUTHERNCALIFORNIA,71,157
311,1961,UTAH,91,LOYOLA-MARYMOUNT,75,166
312,1961,ST.JOSEPH'S,96,WAKEFOREST,86,182
313,1961,OHIOSTATE,87,KENTUCKY,74,161
314,1961,CINCINNATI,69,KANSASSTATE,64,133
315,1961,UTAH,88,ARIZONASTATE,80,168
316,1961,OHIOSTATE,95,ST.JOSEPH'S,69,164
317,1961,CINCINNATI,82,UTAH,67,149
318,1961,CINCINNATI,70,OHIOSTATE,65,135
319,1962,WAKEFOREST,92,YALE,82,174
320,1962,NYU,70,MASSACHUSETTS,50,120
321,1962,VILLANOVA,90,WESTVIRGINIA,75,165
322,1962,BUTLER,56,BOWLINGGREEN,55,111
323,1962,WESTERNKENTUCKY,90,DETROIT,81,171
324,1962,TEXASTECH,68,AIRFORCE,66,134
325,1962,CREIGHTON,87,MEMPHISSTATE,83,170
326,1962,OREGONSTATE,69,SEATTLE,65,134
327,1962,UTAHSTATE,78,ARIZONASTATE,73,151
328,1962,WAKEFOREST,96,ST.JOSEPH'S,85,181
329,1962,VILLANOVA,79,NYU,76,155
330,1962,KENTUCKY,81,BUTLER,60,141
331,1962,OHIOSTATE,93,WESTERNKENTUCKY,73,166
332,1962,COLORADO,67,TEXASTECH,60,127
333,1962,CINCINNATI,66,CREIGHTON,46,112
334,1962,OREGONSTATE,69,PEPPERDINE,67,136
335,1962,UCLA,73,UTAHSTATE,62,135
336,1962,WAKEFOREST,79,VILLANOVA,69,148
337,1962,OHIOSTATE,74,KENTUCKY,64,138
338,1962,CINCINNATI,73,COLORADO,46,119
339,1962,UCLA,88,OREGONSTATE,69,157
340,1962,OHIOSTATE,84,WAKEFOREST,68,152
341,1962,CINCINNATI,72,UCLA,70,142
342,1962,CINCINNATI,71,OHIOSTATE,59,130
343,1963,NYU,93,PITTSBURGH,83,176
344,1963,WESTVIRGINIA,77,CONNECTICUT,71,148
345,1963,ST.JOSEPH'S,82,PRINCETON,81,163
346,1963,BOWLINGGREEN,77,NOTREDAME,72,149
347,1963,LOYOLA-CHICAGO,111,TENNESSEETECH,42,153
348,1963,OKLAHOMACITY,70,COLORADOSTATE,67,137
349,1963,TEXAS,64,TEXAS-ELPASO,47,111
350,1963,ARIZONASTATE,79,UTAHSTATE,75,154
351,1963,OREGONSTATE,70,SEATTLE,67,137
352,1963,DUKE,81,NYU,76,157
353,1963,ST.JOSEPH'S,97,WESTVIRGINIA,88,185
354,1963,ILLINOIS,70,BOWLINGGREEN,67,137
355,1963,LOYOLA-CHICAGO,61,MISSISSIPPISTATE,51,112
356,1963,COLORADO,78,OKLAHOMACITY,72,150
357,1963,CINCINNATI,73,TEXAS,68,141
358,1963,ARIZONASTATE,93,UCLA,79,172
359,1963,OREGONSTATE,65,SANFRANCISCO,61,126
360,1963,DUKE,73,ST.JOSEPH'S,59,132
361,1963,LOYOLA-CHICAGO,79,ILLINOIS,64,143
362,1963,CINCINNATI,67,COLORADO,60,127
363,1963,OREGONSTATE,83,ARIZONASTATE,65,148
364,1963,LOYOLA-CHICAGO,94,DUKE,75,169
365,1963,CINCINNATI,80,OREGONSTATE,46,126
366,1963,LOYOLA-CHICAGO,60,CINCINNATI,58,118
367,1964,VILLANOVA,77,PROVIDENCE,66,143
368,1964,CONNECTICUT,53,TEMPLE,48,101
369,1964,PRINCETON,86,VMI,60,146
370,1964,OHIO,71,LOUISVILLE,69,140
371,1964,LOYOLA-CHICAGO,101,MURRAYSTATE,91,192
372,1964,CREIGHTON,89,OKLAHOMACITY,78,167
373,1964,TEXAS-ELPASO,68,TEXASA&M,62,130
374,1964,SEATTLE,61,OREGONSTATE,57,118
375,1964,UTAHSTATE,92,ARIZONASTATE,90,182
376,1964,DUKE,87,VILLANOVA,73,160
377,1964,CONNECTICUT,52,PRINCETON,50,102
378,1964,OHIO,85,KENTUCKY,69,154
379,1964,MICHIGAN,84,LOYOLA-CHICAGO,80,164
380,1964,WICHITASTATE,84,CREIGHTON,68,152
381,1964,KANSASSTATE,64,TEXAS-ELPASO,60,124
382,1964,UCLA,95,SEATTLE,90,185
383,1964,SANFRANCISCO,64,UTAHSTATE,58,122
384,1964,DUKE,101,CONNECTICUT,54,155
385,1964,MICHIGAN,69,OHIO,57,126
386,1964,KANSASSTATE,94,WICHITASTATE,86,180
387,1964,UCLA,76,SANFRANCISCO,72,148
388,1964,DUKE,91,MICHIGAN,80,171
389,1964,UCLA,90,KANSASSTATE,84,174
390,1964,UCLA,98,DUKE,83,181
391,1965,PRINCETON,60,PENNSTATE,58,118
392,1965,ST.JOSEPH'S,67,CONNECTICUT,61,128
393,1965,DAYTON,66,OHIO,65,131
394,1965,DEPAUL,99,EASTERNKENTUCKY,52,151
395,1965,HOUSTON,99,NOTREDAME,98,197
396,1965,OKLAHOMACITY,70,COLORADOSTATE,68,138
397,1965,PRINCETON,66,N.CAROLINASTATE,48,114
398,1965,PROVIDENCE,81,ST.JOSEPH'S,73,154
399,1965,MICHIGAN,98,DAYTON,71,169
400,1965,VANDERBILT,83,DEPAUL,78,161
401,1965,OKLAHOMASTATE,75,HOUSTON,60,135
402,1965,WICHITASTATE,86,SMU,81,167
403,1965,SANFRANCISCO,91,OKLAHOMACITY,67,158
404,1965,UCLA,100,BRIGHAMYOUNG,76,176
405,1965,PRINCETON,109,PROVIDENCE,69,178
406,1965,MICHIGAN,87,VANDERBILT,85,172
407,1965,WICHITASTATE,54,OKLAHOMASTATE,46,100
408,1965,UCLA,101,SANFRANCISCO,93,194
409,1965,MICHIGAN,93,PRINCETON,76,169
410,1965,UCLA,108,WICHITASTATE,89,197
411,1965,UCLA,91,MICHIGAN,80,171
412,1966,ST.JOSEPH'S,65,PROVIDENCE,48,113
413,1966,DAVIDSON,95,RHODEISLAND,65,160
414,1966,DAYTON,58,MIAMI(OHIO),51,109
415,1966,WESTERNKENTUCKY,105,LOYOLA-CHICAGO,86,191
416,1966,TEXAS-ELPASO,89,OKLAHOMACITY,74,163
417,1966,HOUSTON,82,COLORADOSTATE,76,158
418,1966,DUKE,76,ST.JOSEPH'S,74,150
419,1966,SYRACUSE,94,DAVIDSON,78,172
420,1966,KENTUCKY,86,DAYTON,79,165
421,1966,MICHIGAN,80,WESTERNKENTUCKY,79,159
422,1966,TEXAS-ELPASO,78,CINCINNATI,76,154
423,1966,KANSAS,76,SMU,70,146
424,1966,OREGONSTATE,63,HOUSTON,60,123
425,1966,UTAH,83,PACIFIC,74,157
426,1966,DUKE,91,SYRACUSE,81,172
427,1966,KENTUCKY,84,MICHIGAN,77,161
428,1966,TEXAS-ELPASO,81,KANSAS,80,161
429,1966,UTAH,70,OREGONSTATE,64,134
430,1966,KENTUCKY,83,DUKE,79,162
431,1966,TEXAS-ELPASO,85,UTAH,78,163
432,1966,TEXAS-ELPASO,72,KENTUCKY,65,137
433,1967,PRINCETON,68,WESTVIRGINIA,57,125
434,1967,ST.JOHN'S,57,TEMPLE,53,110
435,1967,BOSTONCOLLEGE,48,CONNECTICUT,42,90
436,1967,DAYTON,69,WESTERNKENTUCKY,67,136
437,1967,VIRGINIATECH,82,TOLEDO,76,158
438,1967,HOUSTON,59,NEWMEXICOSTATE,58,117
439,1967,TEXAS-ELPASO,62,SEATTLE,54,116
440,1967,NORTHCAROLINA,78,PRINCETON,70,148
441,1967,BOSTONCOLLEGE,63,ST.JOHN'S,62,125
442,1967,DAYTON,53,TENNESSEE,52,105
443,1967,VIRGINIATECH,79,INDIANA,70,149
444,1967,HOUSTON,66,KANSAS,53,119
445,1967,SMU,83,LOUISVILLE,81,164
446,1967,PACIFIC,72,TEXAS-ELPASO,63,135
447,1967,UCLA,109,WYOMING,60,169
448,1967,NORTHCAROLINA,96,BOSTONCOLLEGE,80,176
449,1967,DAYTON,71,VIRGINIATECH,66,137
450,1967,HOUSTON,83,SMU,75,158
451,1967,UCLA,80,PACIFIC,64,144
452,1967,DAYTON,76,NORTHCAROLINA,62,138
453,1967,UCLA,73,HOUSTON,58,131
454,1967,UCLA,79,DAYTON,64,143
455,1968,ST.BONAVENTURE,102,BOSTONCOLLEGE,93,195
456,1968,DAVIDSON,79,ST.JOHN'S,70,149
457,1968,COLUMBIA,83,LASALLE,69,152
458,1968,E.TENNESSEESTATE,79,FLORIDASTATE,69,148
459,1968,MARQUETTE,72,BOWLINGGREEN,71,143
460,1968,HOUSTON,94,LOYOLA-CHICAGO,76,170
461,1968,NEWMEXICOSTATE,68,WEBERSTATE,57,125
462,1968,NORTHCAROLINA,91,ST.BONAVENTURE,72,163
463,1968,DAVIDSON,61,COLUMBIA,59,120
464,1968,OHIOSTATE,79,E.TENNESSEESTATE,72,151
465,1968,KENTUCKY,107,MARQUETTE,89,196
466,1968,HOUSTON,91,LOUISVILLE,75,166
467,1968,TCU,77,KANSASSTATE,72,149
468,1968,UCLA,58,NEWMEXICOSTATE,49,107
469,1968,SANTACLARA,86,NEWMEXICO,73,159
470,1968,NORTHCAROLINA,70,DAVIDSON,66,136
471,1968,OHIOSTATE,82,KENTUCKY,81,163
472,1968,HOUSTON,103,TCU,68,171
473,1968,UCLA,87,SANTACLARA,66,153
474,1968,NORTHCAROLINA,80,OHIOSTATE,66,146
475,1968,UCLA,101,HOUSTON,69,170
476,1968,UCLA,78,NORTHCAROLINA,55,133
477,1969,DUQUESNE,74,ST.JOSEPH'S,52,126
478,1969,DAVIDSON,75,VILLANOVA,61,136
479,1969,ST.JOHN'S,72,PRINCETON,63,135
480,1969,MIAMI(OHIO),63,NOTREDAME,60,123
481,1969,MARQUETTE,82,MURRAYSTATE,62,144
482,1969,TEXASA&M,81,TRINITY,66,147
483,1969,COLORADOSTATE,52,DAYTON,50,102
484,1969,NEWMEXICOSTATE,74,BRIGHAMYOUNG,62,136
485,1969,WEBERSTATE,75,SEATTLE,73,148
486,1969,NORTHCAROLINA,79,DUQUESNE,78,157
487,1969,DAVIDSON,79,ST.JOHN'S,69,148
488,1969,PURDUE,91,MIAMI(OHIO),71,162
489,1969,MARQUETTE,81,KENTUCKY,74,155
490,1969,DRAKE,81,TEXASA&M,63,144
491,1969,COLORADOSTATE,64,COLORADO,56,120
492,1969,UCLA,53,NEWMEXICOSTATE,38,91
493,1969,SANTACLARA,63,WEBERSTATE,59,122
494,1969,NORTHCAROLINA,87,DAVIDSON,85,172
495,1969,PURDUE,75,MARQUETTE,73,148
496,1969,DRAKE,84,COLORADOSTATE,77,161
497,1969,UCLA,90,SANTACLARA,52,142
498,1969,PURDUE,92,NORTHCAROLINA,65,157
499,1969,UCLA,85,DRAKE,82,167
500,1969,UCLA,92,PURDUE,72,164
501,1970,ST.BONAVENTURE,85,DAVIDSON,72,157
502,1970,VILLANOVA,77,TEMPLE,69,146
503,1970,NIAGARA,79,PENNSYLVANIA,69,148
504,1970,JACKSONVILLE,109,WESTERNKENTUCKY,96,205
505,1970,NOTREDAME,112,OHIO,82,194
506,1970,NEWMEXICO,101,RICE,77,178
507,1970,HOUSTON,71,DAYTON,64,135
508,1970,LONGBEACHSTATE,92,WEBERSTATE,73,165
509,1970,UTAHSTATE,91,TEXAS-ELPASO,81,172
510,1970,ST.BONAVENTURE,80,N.CAROLINASTATE,68,148
511,1970,VILLANOVA,98,NIAGARA,73,171
512,1970,JACKSONVILLE,104,IOWA,103,207
513,1970,KENTUCKY,109,NOTREDAME,99,208
514,1970,NEWMEXICO,70,KANSASSTATE,66,136
515,1970,DRAKE,92,HOUSTON,87,179
516,1970,UCLA,88,LONGBEACHSTATE,65,153
517,1970,UTAHSTATE,69,SANTACLARA,68,137
518,1970,ST.BONAVENTURE,97,VILLANOVA,74,171
519,1970,JACKSONVILLE,106,KENTUCKY,100,206
520,1970,NEWMEXICO,87,DRAKE,78,165
521,1970,UCLA,101,UTAHSTATE,79,180
522,1970,JACKSONVILLE,91,ST.BONAVENTURE,83,174
523,1970,UCLA,93,NEWMEXICO,77,170
524,1970,UCLA,80,JACKSONVILLE,69,149
525,1971,VILLANOVA,93,ST.JOSEPH'S,75,168
526,1971,FORDHAM,105,FURMAN,74,179
527,1971,PENNSYLVANIA,70,DUQUESNE,65,135
528,1971,WESTERNKENTUCKY,74,JACKSONVILLE,72,146
529,1971,MARQUETTE,62,MIAMI(OHIO),47,109
530,1971,HOUSTON,72,NEWMEXICOSTATE,69,141
531,1971,NOTREDAME,102,TCU,94,196
532,1971,BRIGHAMYOUNG,91,UTAHSTATE,82,173
533,1971,LONGBEACHSTATE,77,WEBERSTATE,66,143
534,1971,VILLANOVA,85,FORDHAM,75,160
535,1971,PENNSYLVANIA,79,SOUTHCAROLINA,64,143
536,1971,WESTENKENTUCKY,107,KENTUCKY,83,190
537,1971,OHIOSTATE,60,MARQUETTE,59,119
538,1971,KANSAS,78,HOUSTON,77,155
539,1971,DRAKE,79,NOTREDAME,72,151
540,1971,UCLA,91,BRIGHAMYOUNG,73,164
541,1971,LONGBEACHSTATE,78,PACIFIC,65,143
542,1971,VILLANOVA,90,PENNSYLVANIA,47,137
543,1971,WESTERNKENTUCKY,81,OHIOSTATE,78,159
544,1971,KANSAS,73,DRAKE,71,144
545,1971,UCLA,57,LONGBEACHSTATE,55,112
546,1971,VILLANOVA,92,WESTERNKENTUCKY,89,181
547,1971,UCLA,68,KANSAS,60,128
548,1971,UCLA,68,VILLANOVA,62,130
549,1972,FLORIDASTATE,83,EASTERNKENTUCKY,81,164
550,1972,MARQUETTE,73,OHIO,49,122
551,1972,SOUTHCAROLINA,53,TEMPLE,51,104
552,1972,PENNSYLVANIA,76,PROVIDENCE,60,136
553,1972,VILLANOVA,85,EASTCAROLINA,70,155
554,1972,SWLOUISIANA,112,MARSHALL,101,213
555,1972,TEXAS,85,HOUSTON,74,159
556,1972,WEBERSTATE,91,HAWAII,64,155
557,1972,LONGBEACHSTATE,95,BRIGHAMYOUNG,90,185
558,1972,FLORIDASTATE,70,MINNESOTA,56,126
559,1972,KENTUCKY,85,MARQUETTE,69,154
560,1972,NORTHCAROLINA,92,SOUTHCAROLINA,69,161
561,1972,PENNSYLVANIA,78,VILLANOVA,67,145
562,1972,LOUISVILLE,88,SWLOUISIANA,84,172
563,1972,KANSASSTATE,66,TEXAS,55,121
564,1972,UCLA,90,WEBERSTATE,58,148
565,1972,LONGBEACHSTATE,75,SANFRANCISCO,55,130
566,1972,FLORIDASTATE,73,KENTUCKY,54,127
567,1972,NORTHCAROLINA,73,PENNSYLVANIA,59,132
568,1972,LOUISVILLE,72,KANSASSTATE,65,137
569,1972,UCLA,73,LONGBEACHSTATE,57,130
570,1972,FLORIDASTATE,79,NORTHCAROLINA,75,154
571,1972,UCLA,96,LOUISVILLE,77,173
572,1972,UCLA,81,FLORIDASTATE,76,157
573,1973,SOUTHCAROLINA,78,TEXASTECH,70,148
574,1973,SWLOUISIANA,102,HOUSTON,89,191
575,1973,PROVIDENCE,89,ST.JOSEPH'S,76,165
576,1973,PENNSYLVANIA,62,ST.JOHN'S,61,123
577,1973,SYRACUSE,83,FURMAN,82,165
578,1973,MARQUETTE,77,MIAMI(OHIO),62,139
579,1973,AUSTINPEAY,77,JACKSONVILLE,75,152
580,1973,ARIZONASTATE,103,OKLAHOMACITY,78,181
581,1973,LONGBEACHSTATE,88,WEBERSTATE,75,163
582,1973,MEMPHISSTATE,90,SOUTHCAROLINA,76,166
583,1973,KANSASSTATE,66,SWLOUISIANA,63,129
584,1973,PROVIDENCE,87,PENNSYLVANIA,65,152
585,1973,MARYLAND,91,SYRACUSE,75,166
586,1973,INDIANA,75,MARQUETTE,69,144
587,1973,KENTUCKY,106,AUSTINPEAY,100,206
588,1973,UCLA,98,ARIZONASTATE,81,179
589,1973,SANFRANCISCO,77,LONGBEACHSTATE,67,144
590,1973,MEMPHISSTATE,92,KANSASSTATE,72,164
591,1973,PROVIDENCE,103,MARYLAND,89,192
592,1973,INDIANA,72,KENTUCKY,65,137
593,1973,UCLA,54,SANFRANCISCO,39,93
594,1973,MEMPHISSTATE,98,PROVIDENCE,85,183
595,1973,UCLA,70,INDIANA,59,129
596,1973,UCLA,87,MEMPHISSTATE,66,153
597,1974,PROVIDENCE,84,PENNSYLVANIA,69,153
598,1974,PITTSBURGH,54,ST.JOSEPH'S,42,96
599,1974,FURMAN,75,SOUTHCAROLINA,67,142
600,1974,DAYTON,88,CALSTATE-LA,80,168
601,1974,NEWMEXICO,73,IDAHOSTATE,65,138
602,1974,MARQUETTE,85,OHIO,59,144
603,1974,NOTREDAME,108,AUSTINPEAY,66,174
604,1974,CREIGHTON,77,TEXAS,61,138
605,1974,ORALROBERTS,86,SYRACUSE,82,168
606,1974,N.CAROLINASTATE,92,PROVIDENCE,78,170
607,1974,PITTSBURGH,81,FURMAN,78,159
608,1974,UCLA,111,DAYTON,100,211
609,1974,SANFRANCISCO,64,NEWMEXICO,61,125
610,1974,MARQUETTE,69,VANDERBILT,61,130
611,1974,MICHIGAN,77,NOTREDAME,68,145
612,1974,KANSAS,55,CREIGHTON,54,109
613,1974,ORALROBERTS,96,LOUISVILLE,93,189
614,1974,N.CAROLINASTATE,100,PITTSBURGH,72,172
615,1974,UCLA,83,SANFRANCISCO,60,143
616,1974,MARQUETTE,72,MICHIGAN,70,142
617,1974,KANSAS,93,ORALROBERTS,90,183
618,1974,N.CAROLINASTATE,80,UCLA,77,157
619,1974,MARQUETTE,64,KANSAS,51,115
620,1974,N.CAROLINASTATE,76,MARQUETTE,64,140
621,1975,UCLA,103,MICHIGAN,91,194
622,1975,MONTANA,69,UTAHSTATE,63,132
623,1975,ARIZONASTATE,97,ALABAMA,94,191
624,1975,UNLV,90,SANDIEGOSTATE,80,170
625,1975,MARYLAND,83,CREIGHTON,79,162
626,1975,NOTREDAME,77,KANSAS,71,148
627,1975,CINCINNATI,87,TEXASA&M,79,166
628,1975,LOUISVILLE,91,RUTGERS,78,169
629,1975,SYRACUSE,87,LASALLE,83,170
630,1975,NORTHCAROLINA,93,NEWMEXICOSTATE,69,162
631,1975,KANSASSTATE,69,PENNSYLVANIA,62,131
632,1975,BOSTONCOLLEGE,82,FURMAN,76,158
633,1975,INDIANA,78,TEXAS-ELPASO,53,131
634,1975,OREGONSTATE,78,M.TENNESSEESTATE,67,145
635,1975,CENTRALMICHIGAN,77,GEORGETOWN,75,152
636,1975,KENTUCKY,76,MARQUETTE,64,140
637,1975,UCLA,67,MONTANA,64,131
638,1975,ARIZONASTATE,84,UNLV,81,165
639,1975,MARYLAND,83,NOTREDAME,71,154
640,1975,LOUISVILLE,78,CINCINNATI,63,141
641,1975,SYRACUSE,78,NORTHCAROLINA,76,154
642,1975,KANSASSTATE,74,BOSTONCOLLEGE,65,139
643,1975,INDIANA,81,OREGONSTATE,71,152
644,1975,KENTUCKY,90,CENTRALMICHIGAN,73,163
645,1975,UCLA,89,ARIZONASTATE,75,164
646,1975,LOUISVILLE,96,MARYLAND,82,178
647,1975,SYRACUSE,95,KANSASSTATE,87,182
648,1975,KENTUCKY,92,INDIANA,90,182
649,1975,UCLA,75,LOUISVILLE,74,149
650,1975,KENTUCKY,95,SYRACUSE,79,174
651,1975,UCLA,92,KENTUCKY,85,177
652,1976,DEPAUL,69,VIRGINIA,60,129
653,1976,VMI,81,TENNESSEE,75,156
654,1976,RUTGERS,54,PRINCETON,53,107
655,1976,CONNECTICUT,80,HOFSTRA,78,158
656,1976,MICHIGAN,74,WICHITASTATE,73,147
657,1976,NOTREDAME,79,CINCINNATI,78,157
658,1976,MISSOURI,69,WASHINGTON,67,136
659,1976,TEXASTECH,69,SYRACUSE,56,125
660,1976,ALABAMA,79,NORTHCAROLINA,64,143
661,1976,INDIANA,90,ST.JOHN'S,70,160
662,1976,MARQUETTE,79,WESTERNKENTUCKY,60,139
663,1976,WESTERNMICHIGAN,77,VIRGINIATECH,67,144
664,1976,PEPPERDINE,87,MEMPHISSTATE,77,164
665,1976,UCLA,74,SANDIEGOSTATE,64,138
666,1976,UNLV,103,BOISESTATE,78,181
667,1976,ARIZONA,83,GEORGETOWN,76,159
668,1976,VMI,71,DEPAUL,66,137
669,1976,RUTGERS,93,CONNECTICUT,79,172
670,1976,MICHIGAN,80,NOTREDAME,76,156
671,1976,MISSOURI,86,TEXASTECH,75,161
672,1976,INDIANA,74,ALABAMA,69,143
673,1976,MARQUETTE,62,WESTERNMICHIGAN,57,119
674,1976,UCLA,70,PEPPERDINE,61,131
675,1976,ARIZONA,114,UNLV,109,223
676,1976,RUTGERS,91,VMI,75,166
677,1976,MICHIGAM,95,MISSOURI,88,183
678,1976,INDIANA,65,MARQUETTE,56,121
679,1976,UCLA,82,ARIZONA,66,148
680,1976,MICHIGAN,86,RUTGERS,70,156
681,1976,INDIANA,65,UCLA,51,116
682,1976,INDIANA,86,MICHIGAN,68,154
683,1977,VMI,73,DUQUESNE,66,139
684,1977,KENTUCKY,72,PRINCETON,58,130
685,1977,NOTREDAME,90,HOFSTRA,83,173
686,1977,NORTHCAROLINA,69,PURDUE,66,135
687,1977,UCLA,87,LOUISVILLE,79,166
688,1977,IDAHOSTATE,83,LONGBEACHSTATE,72,155
689,1977,UTAH,72,ST.JOHN'S,68,140
690,1977,UNLV,121,SANFRANCISCO,95,216
691,1977,MICHIGAN,92,HOLYCROSS,81,173
692,1977,DETROIT,93,M.TENNESSEESTATE,76,169
693,1977,N.C.-CHARLOTTE,91,CENTRALMICHIGAN,86,177
694,1977,SYRACUSE,93,TENNESSEE,88,181
695,1977,MARQUETTE,66,CINCINNATI,51,117
696,1977,KANSASSTATE,87,PROVIDENCE,80,167
697,1977,WAKEFOREST,86,ARKANSAS,80,166
698,1977,SOUTHERNILLINOIS,81,ARIZONA,77,158
699,1977,KENTUCKY,93,VMI,78,171
700,1977,NORTHCAROLINA,79,NOTREDAME,77,156
701,1977,IDAHOSTATE,76,UCLA,75,151
702,1977,UNLV,88,UTAH,83,171
703,1977,MICHIGAN,86,DETROIT,81,167
704,1977,N.C.-CHARLOTTE,81,SYRACUSE,59,140
705,1977,MARQUETTE,67,KANSASSTATE,66,133
706,1977,WAKEFOREST,86,SOUTHERNILLINOIS,81,167
707,1977,NORTHCAROLINA,79,KENTUCKY,72,151
708,1977,UNLV,107,IDAHOSTATE,90,197
709,1977,N.C.-CHARLOTTE,75,MICHIGAN,68,143
710,1977,MARQUETTE,82,WAKEFOREST,68,150
711,1977,NORTHCAROLINA,84,UNLV,83,167
712,1977,MARQUETTE,51,N.C.-CHARLOTTE,49,100
713,1977,MARQUETTE,67,NORTHCAROLINA,59,126
714,1978,MICHIGANSTATE,77,PROVIDENCE,63,140
715,1978,WESTERNKENTUCKY,87,SYRACUSE,86,173
716,1978,MIAMI(OHIO),84,MARQUETTE,81,165
717,1978,KENTUCKY,85,FLORIDASTATE,76,161
718,1978,UCLA,83,KANSAS,76,159
719,1978,ARKANSAS,73,WEBERSTATE,52,125
720,1978,SANFRANCISCO,68,NORTHCAROLINA,64,132
721,1978,CALSTATE-FULLERTON,90,NEWMEXICO,85,175
722,1978,DUKE,63,RHODEISLAND,62,125
723,1978,PENNSYLVANIA,92,ST.BONAVENTURE,83,175
724,1978,INDIANA,63,FURMAN,62,125
725,1978,VILLANOVA,103,LASALLE,97,200
726,1978,UTAH,86,MISSOURI,79,165
727,1978,NOTREDAME,100,HOUSTON,77,177
728,1978,DEPAUL,80,CREIGHTON,78,158
729,1978,LOUISVILLE,76,ST.JOHN'S,68,144
730,1978,MICHIGANSTATE,90,WESTERNKENTUCKY,69,159
731,1978,KENTUCKY,91,MIAMI(OHIO),69,160
732,1978,ARKANSAS,74,UCLA,70,144
733,1978,CALSTATE-FULLERTON,75,SANFRANCISCO,72,147
734,1978,DUKE,84,PENNSYLVANIA,80,164
735,1978,VILLANOVA,61,INDIANA,60,121
736,1978,NOTREDAME,69,UTAH,56,125
737,1978,DEPAUL,90,LOUISVILLE,89,179
738,1978,KENTUCKY,52,MICHIGANSTATE,49,101
739,1978,ARKANSAS,61,CALSTATE-FULLERTON,58,119
740,1978,DUKE,90,VILLANOVA,72,162
741,1978,NOTREDAME,84,DEPAUL,64,148
742,1978,KENTUCKY,64,ARKANSAS,59,123
743,1978,DUKE,90,NOTREDAME,86,176
744,1978,KENTUCKY,94,DUKE,88,182
745,1979,ST.JOHN'S,75,TEMPLE,70,145
746,1979,PENNSYLVANIA,73,IONA,69,142
747,1979,LAMAR,95,DETROIT,87,182
748,1979,TENNESSEE,97,EASTERNKENTUCKY,81,178
749,1979,SOUTHERNCALIFORNIA,86,UTAHSTATE,67,153
750,1979,PEPPERDINE,92,UTAH,88,180
751,1979,WEBERSTATE,81,NEWMEXICOSTATE,78,159
752,1979,VIRGINIATECH,70,JACKSONVILLE,53,123
753,1979,ST.JOHN'S,80,DUKE,78,158
754,1979,RUTGERS,64,GEORGETOWN,58,122
755,1979,PENNSYLVANIA,72,NORTHCAROLINA,71,143
756,1979,SYRACUSE,89,CONNECTICUT,81,170
757,1979,MICHIGANSTATE,95,LAMAR,64,159
758,1979,LSU,71,APPALACHIANSTATE,57,128
759,1979,NOTREDAME,73,TENNESSEE,67,140
760,1979,TOLEDO,74,IOWA,72,146
761,1979,DEPAUL,89,SOUTHERNCALIFORNIA,78,167
762,1979,MARQUETTE,73,PACIFIC,48,121
763,1979,UCLA,76,PEPPERDINE,71,147
764,1979,SANFRANCISCO,86,BRIGHAMYOUNG,63,149
765,1979,ARKANSAS,74,WEBERSTATE,63,137
766,1979,LOUISVILLE,69,SOUTHALABAMA,66,135
767,1979,INDIANASTATE,86,VIRGINIATECH,69,155
768,1979,OKLAHOMA,90,TEXAS,76,166
769,1979,ST.JOHN'S,67,RUTGERS,65,132
770,1979,PENNSYLVANIA,84,SYRACUSE,76,160
771,1979,MICHIGANSTATE,87,LSU,71,158
772,1979,NOTREDAME,79,TOLEDO,71,150
773,1979,DEPAUL,62,MARQUETTE,56,118
774,1979,UCLA,99,SANFRANCISCO,81,180
775,1979,ARKANSAS,73,LOUISVILLE,62,135
776,1979,INDIANASTATE,93,OKLAHOMA,72,165
777,1979,PENNSYLVANIA,64,ST.JOHN'S,62,126
778,1979,MICHIGANSTATE,80,NOTREDAME,68,148
779,1979,DEPAUL,95,UCLA,91,186
780,1979,INDIANASTATE,73,ARKANSAS,71,144
781,1979,MICHIGANSTATE,101,PENNSYLVANIA,67,168
782,1979,INDIANASTATE,76,DEPAUL,74,150
783,1979,MICHIGANSTATE,75,INDIANASTATE,64,139
784,1980,VILLANOVA,77,MARQUETTE,59,136
785,1980,IOWA,86,VCU,72,158
786,1980,IONA,84,HOLYCROSS,78,162
787,1980,TENNESSEE,80,FURMAN,69,149
788,1980,ALCORNSTATE,70,SOUTHALABAMA,62,132
789,1980,MISSOURI,61,SANJOSESTATE,51,112
790,1980,TEXASA&M,55,BRADLEY,53,108
791,1980,KANSASSTATE,71,ARKANSAS,53,124
792,1980,FLORIDASTATE,94,TOLEDO,91,185
793,1980,PENNSYLVANIA,62,WASHINGTONSTATE,55,117
794,1980,PURDUE,90,LASALLE,82,172
795,1980,VIRGINIATECH,89,WESTERNKENTUCKY,85,174
796,1980,UCLA,87,OLDDOMINION,74,161
797,1980,ARIZONASTATE,99,LOYOLA-MARYMOUNT,71,170
798,1980,CLEMSON,76,UTAHSTATE,73,149
799,1980,LAMAR,87,WEBERSTATE,86,173
800,1980,SYRACUSE,97,VILLANOVA,83,180
801,1980,IOWA,77,N.CAROLINASTATE,64,141
802,1980,GEORGETOWN,74,IONA,71,145
803,1980,MARYLAND,86,TENNESSEE,75,161
804,1980,LSU,98,ALCORNSTATE,88,186
805,1980,MISSOURI,87,NOTREDAME,84,171
806,1980,TEXASA&M,78,NORTHCAROLINA,61,139
807,1980,LOUISVILLE,71,KANSASSTATE,69,140
808,1980,KENTUCKY,97,FLORIDASTATE,78,175
809,1980,DUKE,52,PENNSYLVANIA,42,94
810,1980,PURDUE,87,ST.JOHN'S,72,159
811,1980,INDIANA,68,VIRGINIATECH,59,127
812,1980,UCLA,77,DEPAUL,71,148
813,1980,OHIOSTATE,89,ARIZONASTATE,75,164
814,1980,CLEMSON,71,BRIGHAMYOUNG,66,137
815,1980,LAMAR,81,OREGONSTATE,77,158
816,1980,IOWA,88,SYRACUSE,77,165
817,1980,GEORGETOWN,74,MARYLAND,68,142
818,1980,LSU,68,MISSOURI,63,131
819,1980,LOUISVILLE,66,TEXASA&M,55,121
820,1980,DUKE,55,KENTUCKY,54,109
821,1980,PURDUE,76,INDIANA,69,145
822,1980,UCLA,72,OHIOSTATE,68,140
823,1980,CLEMSON,74,LAMAR,66,140
824,1980,IOWA,81,GEORGETOWN,80,161
825,1980,LOUISVILLE,86,LSU,66,152
826,1980,PURDUE,68,DUKE,60,128
827,1980,UCLA,85,CLEMSON,74,159
828,1980,LOUISVILLE,80,IOWA,72,152
829,1980,UCLA,67,PURDUE,62,129
830,1980,LOUISVILLE,59,UCLA,54,113
831,1981,LAMAR,71,MISSOURI,67,138
832,1981,ARKANSAS,73,MERCER,67,140
833,1981,WICHITASTATE,95,SOUTHERN-B.R.,70,165
834,1981,KANSAS,69,MISSISSIPPI,66,135
835,1981,ST.JOSEPH'S,59,CREIGHTON,57,116
836,1981,BOSTONCOLLEGE,93,BALLSTATE,90,183
837,1981,MARYLAND,81,TENNESSEE-CHAT,69,150
838,1981,ALABAMA-BIRMINGHAM,93,WESTERNKENTUCKY,68,161
839,1981,KANSASSTATE,64,SANFRANCISCO,60,124
840,1981,WYOMING,78,HOWARD,43,121
841,1981,NOTHEASTERN,55,FRESNOSTATE,53,108
842,1981,PITTSBUGH,70,IDAHO,69,139
843,1981,VILLANOVA,90,HOUSTON,72,162
844,1981,VCU,85,LONGISLAND,69,154
845,1981,BRIGHAMYOUNG,60,PRINCETON,51,111
846,1981,JAMESMADISON,61,GEORGETOWN,55,116
847,1981,LSU,100,LAMAR,78,178
848,1981,ARKANSAS,74,LOUISVILLE,73,147
849,1981,WICHITASTATE,60,IOWA,56,116
850,1981,KANSAS,88,ARIZONASTATE,71,159
851,1981,ST.JOSEPH'S,49,DEPAUL,48,97
852,1981,BOSTONCOLLEGE,67,WAKEFOREST,64,131
853,1981,INDIANA,99,MARYLAND,64,163
854,1981,ALABAMA-BIRMINGHAM,69,KENTUCKY,62,131
855,1981,KANSASSTATE,50,OREGONSTATE,48,98
856,1981,ILLINOIS,67,WYOMING,65,132
857,1981,UTAH,94,NORTHEASTERN,69,163
858,1981,NORTHCAROLINA,74,PITTSBURGH,57,131
859,1981,VIRGINIA,54,VILLANOVA,50,104
860,1981,TENNESSEE,58,VCU,56,114
861,1981,BRIGHAMYOUNG,78,UCLA,55,133
862,1981,NOTREDAME,54,JAMESMADISON,45,99
863,1981,LSU,72,ARKANSAS,56,128
864,1981,WICHITASTATE,66,KANSAS,65,131
865,1981,ST.JOSEPH'S,42,BOSTONCOLLEGE,41,83
866,1981,INDIANA,87,ALABAMA-BIRMINGHAM,72,159
867,1981,KANSASSTATE,57,ILLINOIS,52,109
868,1981,NORTHCAROLINA,61,UTAH,56,117
869,1981,VIRGINIA,62,TENNESSEE,48,110
870,1981,BRIGHAMYOUNG,51,NOTREDAME,50,101
871,1981,LSU,96,WICHITASTATE,85,181
872,1981,INDIANA,78,ST.JOSEPH'S,46,124
873,1981,NORTHCAROLINA,82,KANSASSTATE,68,150
874,1981,VIRGINIA,74,BRIGHAMYOUNG,60,134
875,1981,INDIANA,67,LSU,49,116
876,1981,NORTHCAROLINA,78,VIRGINIA,65,143
877,1981,INDIANA,63,NORTHCAROLINA,50,113
878,1982,JAMESMADISON,55,OHIOSTATE,48,103
879,1982,ST.JOHN'S,66,PENNSYLVANIA,56,122
880,1982,NORTHEASTERN,63,ST.JOSEPH'S,62,125
881,1982,WAKEFOREST,74,OLDDOMINION,57,131
882,1982,BOSTONCOLLEGE,70,SANFRANCISCO,66,136
883,1982,KANSASSTATE,77,NORTHERNILLINOIS,68,145
884,1982,HOUSTON,94,ALCORNSTATE,84,178
885,1982,MARQUETTE,67,EVANSVILLE,62,129
886,1982,TENNESSEE,61,SWLOUISIANA,57,118
887,1982,INDIANA,94,ROBERTMORRIS,62,156
888,1982,M.TENNESSEESTATE,50,KENTUCKY,44,94
889,1982,TENNESSEE-CHAT,58,N.CAROLINASTATE,51,109
890,1982,WYOMING,61,SOUTHERNCALIFORNIA,58,119
891,1982,WESTVIRGINIA,102,NORTHCAROLINAA&T,72,174
892,1982,IOWA,70,NELOUISIANA,63,133
893,1982,PEPPERDINE,99,PITTSBURGH,88,187
894,1982,NORTHCAROLINA,52,JAMESMADISON,50,102
895,1982,ALABAMA,69,ST.JOHN'S,68,137
896,1982,VILLANOVA,76,NORTHEASTERN,72,148
897,1982,MEMPHISSTATE,56,WAKEFOREST,55,111
898,1982,BOSTONCOLLEGE,82,DEPAUL,75,157
899,1982,KANSASSTATE,65,ARKANSAS,64,129
900,1982,HOUSTON,78,TULSA,74,152
901,1982,MISSOURI,73,MARQUETTE,69,142
902,1982,VIRGINIA,54,TENNESSEE,51,105
903,1982,ALABAMA-BIRMINGHAM,80,INDIANA,70,150
904,1982,LOUISVILLE,81,M.TENNESSEESTATE,56,137
905,1982,MINNESOTA,62,TENNESSEE-CHAT,61,123
906,1982,GEORGETOWN,51,WYOMING,43,94
907,1982,FRESNOSTATE,50,WESTVIRGINIA,46,96
908,1982,IDAHO,69,IOWA,67,136
909,1982,OREGONSTATE,70,PEPPERDINE,51,121
910,1982,NORTHCAROLINA,74,ALABAMA,69,143
911,1982,VILLANOVA,70,MEMPHISSTATE,66,136
912,1982,BOSTONCOLLEGE,69,KANSASSTATE,65,134
913,1982,HOUSTON,79,MISSOURI,78,157
914,1982,ALABAMA-BIRMINGHAM,68,VIRGINIA,66,134
915,1982,LOUISVILLE,67,MINNESOTA,61,128
916,1982,GEORGETOWN,58,FRESNOSTATE,40,98
917,1982,OREGONSTATE,60,IDAHO,42,102
918,1982,NORTHCAROLINA,70,VILLANOVA,60,130
919,1982,HOUSTON,99,BOSTONCOLLEGE,92,191
920,1982,LOUISVILLE,75,ALABAMA-BIRMINGHAM,68,143
921,1982,GEORGETOWN,69,OREGONSTATE,45,114
922,1982,NORTHCAROLINA,68,HOUSTON,63,131
923,1982,GEORGETOWN,50,LOUISVILLE,46,96
924,1982,NORTHCAROLINA,63,GEORGETOWN,62,125
925,1983,MARYLAND,52,TENNESSEE-CHAT,51,103
926,1983,GEORGETOWN,68,ALCORNSTATE,63,131
927,1983,LAMAR,73,ALABAMA,50,123
928,1983,IOWA,64,UTAHSTATE,59,123
929,1983,TENNESSEE,57,MARQUETTE,56,113
930,1983,PURDUE,55,ROBERTMORRIS,53,108
931,1983,OHIO,51,ILLINOISSTATE,49,100
932,1983,OKLAHOMA,71,ALABAMA-BIRMINGHAM,63,134
933,1983,WASHINGTONSTATE,62,WEBERSTATE,52,114
934,1983,PRINCETON,56,OKLAHOMASTATE,53,109
935,1983,N.CAROLINASTATE,69,PEPPERDINE,67,136
936,1983,UTAH,52,ILLINOIS,49,101
937,1983,RUTGERS,60,SWLOUISIANA,53,113
938,1983,VCU,76,LASALLE,67,143
939,1983,SYRACUSE,74,MOREHEADSTATE,59,133
940,1983,JAMESMADISON,57,WESTVIRGINIA,50,107
941,1983,HOUSTON,60,MARYLAND,50,110
942,1983,MEMPHISSTATE,66,GEORGETOWN,57,123
943,1983,VILLANOVA,60,LAMAR,58,118
944,1983,IOWA,77,MISSOURI,63,140
945,1983,LOUISVILLE,70,TENNESSEE,57,127
946,1983,ARKANSAS,78,PURDUE,68,146
947,1983,KENTUCKY,57,OHIO,40,97
948,1983,INDIANA,63,OKLAHOMA,49,112
949,1983,VIRGINIA,54,WASHINGTONSTATE,49,103
950,1983,BOSTONCOLLEGE,51,PRINCETON,42,93
951,1983,N.CAROLINASTATE,71,UNLV,70,141
952,1983,UTAH,67,UCLA,61,128
953,1983,ST.JOHN'S,66,RUTGERS,55,121
954,1983,GEORGIA,56,VCU,54,110
955,1983,OHIOSTATE,79,SYRACUSE,74,153
956,1983,NORTHCAROLINA,68,JAMESMADISON,49,117
957,1983,HOUSTON,70,MEMPHISSTATE,63,133
958,1983,VILLANOVA,55,IOWA,54,109
959,1983,LOUISVILLE,65,ARKANSAS,63,128
960,1983,KENTUCKY,64,INDIANA,59,123
961,1983,VIRGINIA,95,BOSTONCOLLEGE,92,187
962,1983,N.CAROLINASTATE,75,UTAH,56,131
963,1983,GEORGIA,70,ST.JOHN'S,67,137
964,1983,NORTHCAROLINA,64,OHIOSTATE,51,115
965,1983,HOUSTON,89,VILLANOVA,71,160
966,1983,LOUISVILLE,80,KENTUCKY,68,148
967,1983,N.CAROLINASTATE,63,VIRGINIA,62,125
968,1983,GEORGIA,82,NORTHCAROLINA,77,159
969,1983,HOUSTON,94,LOUISVILLE,81,175
970,1983,N.CAROLINASTATE,67,GEORGIA,60,127
971,1983,N.CAROLINASTATE,54,HOUSTON,52,106
972,1984,BRIGHAMYOUNG,84,ALABAMA-BIRMINGHAM,68,152
973,1984,LOUISVILLE,72,MOREHEADSTATE,59,131
974,1984,WESTVIRGINIA,64,OREGONSTATE,62,126
975,1984,VILLANOVA,84,MARSHALL,72,156
976,1984,SMU,83,MIAMI(OHIO),69,152
977,1984,UNLV,68,PRINCETON,56,124
978,1984,WASHINGTON,64,NEVADA-RENO,54,118
979,1984,DAYTON,74,LSU,66,140
980,1984,TEMPLE,65,ST.JOHN'S,63,128
981,1984,RICHMOND,72,AUBURN,71,143
982,1984,VCU,70,NORTHEASTERN,69,139
983,1984,VIRGINIA,58,IONA,57,115
984,1984,ILLINOISSTATE,49,ALABAMA,48,97
985,1984,KANSAS,57,ALCORNSTATE,56,113
986,1984,MEMPHISSTATE,92,ORALROBERTS,83,175
987,1984,LOUISIANATECH,66,FRESNOSTATE,56,122
988,1984,KENTUCKY,93,BRIGHAMYOUNG,68,161
989,1984,LOUISVILLE,69,TULSA,67,136
990,1984,MARYLAND,102,WESTVIRGINIA,77,179
991,1984,ILLINOIS,64,VILLANOVA,56,120
992,1984,GEORGETOWN,37,SMU,36,73
993,1984,UNLV,73,TEXAS-ELPASO,60,133
994,1984,WASHINGTON,80,DUKE,78,158
995,1984,DAYTON,89,OKLAHOMA,85,174
996,1984,NORTHCAROLINA,77,TEMPLE,66,143
997,1984,INDIANA,75,RICHMOND,67,142
998,1984,SYRACUSE,78,VCU,63,141
999,1984,VIRGINIA,53,ARKANSAS,51,104
1000,1984,DEPAUL,75,ILLINOISSTATE,61,136
1001,1984,WAKEFOREST,69,KANSAS,59,128
1002,1984,MEMPHISSTATE,66,PURDUE,48,114
1003,1984,HOUSTON,77,LOUISIANATECH,69,146
1004,1984,KENTUCKY,72,LOUISVILLE,67,139
1005,1984,ILLINOIS,72,MARYLAND,70,142
1006,1984,GEORGETOWN,62,UNLV,48,110
1007,1984,DAYTON,64,WASHINGTON,58,122
1008,1984,INDIANA,72,NORTHCAROLINA,68,140
1009,1984,VIRGINIA,63,SYRACUSE,55,118
1010,1984,WAKEFOREST,73,DEPAUL,71,144
1011,1984,HOUSTON,78,MEMPHISSTATE,71,149
1012,1984,KENTUCKY,54,ILLINOIS,51,105
1013,1984,GEORGETOWN,61,DAYTON,49,110
1014,1984,VIRGINIA,50,INDIANA,48,98
1015,1984,HOUSTON,68,WAKEFOREST,63,131
1016,1984,GEORGETOWN,53,KENTUCKY,40,93
1017,1984,HOUSTON,49,VIRGINIA,47,96
1018,1984,GEORGETOWN,84,HOUSTON,75,159
1019,1985,ST.JOHN'S,83,SOUTHERN-B.R.,59,142
1020,1985,ARKANSAS,63,IOWA,54,117
1021,1985,KENTUCKY,66,WASHINGTON,58,124
1022,1985,TEXAS-ELPASO,79,TULSA,75,154
1023,1985,N.CAROLINASTATE,65,NEVADA-RENO,56,121
1024,1985,ALABAMA,50,ARIZONA,41,91
1025,1985,VCU,81,MARSHALL,65,146
1026,1985,GEORGETOWN,68,LEHIGH,43,111
1027,1985,TEMPLE,60,VIRGINIATECH,57,117
1028,1985,SMU,85,OLDDOMINION,68,153
1029,1985,LOYOLA-CHICAGO,59,IONA,58,117
1030,1985,GEORGIA,67,WICHITASTATE,59,126
1031,1985,ILLINOIS,76,NORTHEASTERN,57,133
1032,1985,SYRACUSE,70,DEPAUL,65,135
1033,1985,GEORGIATECH,65,MERCER,58,123
1034,1985,OKLAHOMA,96,NORTHCAROLINAA&T,83,179
1035,1985,ILLINOISSTATE,58,SOUTHERNCALIFORNIA,55,113
1036,1985,LOUISIANATECH,78,PITTSBURGH,54,132
1037,1985,OHIOSTATE,75,IOWASTATE,64,139
1038,1985,BOSTONCOLLEGE,55,TEXASTECH,53,108
1039,1985,DUKE,75,PEPPERDINE,62,137
1040,1985,ALABAMA-BIRMINGHAM,70,MICHIGANSTATE,68,138
1041,1985,MEMPHISSTATE,67,PENNSYLVANIA,55,122
1042,1985,MICHIGAN,59,FAIRLEIGHDICKINSON,55,114
1043,1985,VILLANOVA,51,DAYTON,49,100
1044,1985,MARYLAND,69,MIAMI(OHIO),68,137
1045,1985,NAVY,78,LSU,55,133
1046,1985,AUBURN,59,PURDUE,58,117
1047,1985,KANSAS,49,OHIO,38,87
1048,1985,NOTREDAME,79,OREGONSTATE,70,149
1049,1985,NORTHCAROLINA,76,M.TENNESSEESTATE,57,133
1050,1985,ST.JOHN'S,68,ARKANSAS,65,133
1051,1985,KENTUCKY,64,UNLV,61,125
1052,1985,N.CAROLINASTATE,86,TEXAS-ELPASO,73,159
1053,1985,ALABAMA,63,VCU,59,122
1054,1985,GEORGETOWN,63,TEMPLE,46,109
1055,1985,LOYOLA-CHICAGO,70,SMU,57,127
1056,1985,ILLINOIS,74,GEORGIA,58,132
1057,1985,GEORGIATECH,70,SYRACUSE,53,123
1058,1985,OKLAHOMA,75,ILLINOISSTATE,69,144
1059,1985,LOUISIANATECH,79,OHIOSTATE,67,146
1060,1985,BOSTONCOLLEGE,74,DUKE,73,147
1061,1985,MEMPHISSTATE,67,ALABAMA-BIRMINGHAM,66,133
1062,1985,VILLANOVA,59,MICHIGAN,55,114
1063,1985,MARYLAND,64,NAVY,59,123
1064,1985,AUBURN,66,KANSAS,64,130
1065,1985,NORTHCAROLINA,60,NOTREDAME,58,118
1066,1985,ST.JOHN'S,86,KENTUCKY,70,156
1067,1985,N.CAROLINASTATE,61,ALABAMA,55,116
1068,1985,GEORGETOWN,65,LOYOLA-CHICAGO,53,118
1069,1985,GEORGIATECH,61,ILLINOIS,53,114
1070,1985,OKLAHOMA,86,LOUISIANATECH,84,170
1071,1985,MEMPHISSTATE,59,BOSTONCOLLEGE,57,116
1072,1985,VILLANOVA,46,MARYLAND,43,89
1073,1985,NORTHCAROLINA,62,AUBURN,56,118
1074,1985,ST.JOHN'S,69,N.CAROLINASTATE,60,129
1075,1985,GEORGETOWN,60,GEORGIATECH,54,114
1076,1985,MEMPHISSTATE,63,OKLAHOMA,61,124
1077,1985,VILLANOVA,56,NORTHCAROLINA,44,100
1078,1985,GEORGETOWN,77,ST.JOHN'S,59,136
1079,1985,VILLANOVA,52,MEMPHISSTATE,45,97
1080,1985,VILLANOVA,66,GEORGETOWN,64,130
1081,1986,KENTUCKY,75,DAVIDSON,55,130
1082,1986,WESTERNKENTUCKY,67,NEBRASKA,59,126
1083,1986,ALABAMA,97,XAVIER,80,177
1084,1986,ILLINOIS,75,FAIRFIELD,51,126
1085,1986,LSU,94,PURDUE,87,181
1086,1986,MEMPHISSTATE,95,BALLSTATE,63,158
1087,1986,VILLANOVA,71,VIRGINIATECH,62,133
1088,1986,GEORGIATECH,68,MARIST,53,121
1089,1986,ST.JOHN'S,83,MONTANASTATE,74,157
1090,1986,AUBURN,73,ARIZONA,63,136
1091,1986,MARYLAND,69,PEPPERDINE,64,133
1092,1986,UNLV,74,NELOUISIANA,51,125
1093,1986,ALABAMA-BIRMINGHAM,66,MISSOURI,64,130
1094,1986,NORTHCAROLINA,84,UTAH,72,156
1095,1986,BRADLEY,83,TEXAS-ELPASO,65,148
1096,1986,LOUISVILLE,93,DREXEL,73,166
1097,1986,DUKE,85,MISS.VALLEYSTATE,78,163
1098,1986,OLDDOMINION,72,WESTVIRGINIA,64,136
1099,1986,DEPAUL,72,VIRGINIA,68,140
1100,1986,OKLAHOMA,80,NORTHEASTERN,74,154
1101,1986,ST.JOSEPH'S,60,RICHMOND,59,119
1102,1986,CLEVELANDSTATE,83,INDIANA,79,162
1103,1986,NAVY,87,TULSA,68,155
1104,1986,SYRACUSE,101,BROWN,52,153
1105,1986,KANSAS,71,NORTHCAROLINAA&T,46,117
1106,1986,TEMPLE,61,JACKSONVILLE,50,111
1107,1986,MICHIGANSTATE,72,WASHINGTON,70,142
1108,1986,GEORGETOWN,70,TEXASTECH,64,134
1109,1986,N.CAROLINASTATE,66,IOWA,64,130
1110,1986,ARKANSAS-L.R.,90,NOTREDAME,83,173
1111,1986,IOWASTATE,81,MIAMI(OHIO),79,160
1112,1986,MICHIGAN,70,AKRON,64,134
1113,1986,KENTUCKY,71,WESTERNKENTUCKY,64,135
1114,1986,ALABAMA,58,ILLINOIS,56,114
1115,1986,LSU,83,MEMPHISSTATE,81,164
1116,1986,GEORGIATECH,66,VILLANOVA,61,127
1117,1986,AUBURN,81,ST.JOHN'S,65,146
1118,1986,UNLV,70,MARYLAND,64,134
1119,1986,NORTHCAROLINA,77,ALABAMA-BIRMINGHAM,59,136
1120,1986,LOUISVILLE,82,BRADLEY,68,150
1121,1986,DUKE,89,OLDDOMINION,61,150
1122,1986,DEPAUL,74,OKLAHOMA,69,143
1123,1986,CLEVELANDSTATE,75,ST.JOSEPH'S,69,144
1124,1986,NAVY,97,SYRACUSE,85,182
1125,1986,KANSAS,65,TEMPLE,43,108
1126,1986,MICHIGANSTATE,80,GEORGETOWN,68,148
1127,1986,N.CAROLINASTATE,80,ARKANSAS-L.R.,66,146
1128,1986,IOWA,72,MICHIGAN,69,141
1129,1986,KENTUCKY,68,ALABAMA,63,131
1130,1986,LSU,70,GEORGIATECH,64,134
1131,1986,AUBURN,70,UNLV,63,133
1132,1986,LOUISVILLE,94,NORTHCAROLINA,79,173
1133,1986,DUKE,74,DEPAUL,67,141
1134,1986,NAVY,71,CLEVELANDSTATE,70,141
1135,1986,KANSAS,96,MICHIGANSTATE,86,182
1136,1986,N.CAROLINASTATE,70,IOWASTATE,66,136
1137,1986,LSU,59,KENTUCKY,57,116
1138,1986,LOUISVILLE,84,AUBURN,76,160
1139,1986,DUKE,71,NAVY,50,121
1140,1986,KANSAS,75,N.CAROLINASTATE,67,142
1141,1986,LOUISVILLE,88,LSU,77,165
1142,1986,DUKE,71,KANSAS,67,138
1143,1986,LOUISVILLE,72,DUKE,69,141
1144,1987,UNLV,95,IDAHOSTATE,70,165
1145,1987,KANSASSTATE,82,GEORGIA,79,161
1146,1987,WYOMING,64,VIRGINIA,60,124
1147,1987,UCLA,92,CENTRALMICHIGAN,73,165
1148,1987,OKLAHOMA,74,TULSA,69,143
1149,1987,PITTSBURGH,93,MARIST,68,161
1150,1987,TEXAS-ELPASO,98,ARIZONA,91,189
1151,1987,IOWA,99,SANTACLARA,76,175
1152,1987,INDIANA,92,FAIRFIELD,58,150
1153,1987,AUBURN,62,SANDIEGO,61,123
1154,1987,DUKE,58,TEXASA&M,51,109
1155,1987,XAVIER(OHIO),70,MISSOURI,69,139
1156,1987,ST.JOHN'S,57,WICHITASTATE,55,112
1157,1987,DEPAUL,76,LOUISIANATECH,62,138
1158,1987,LSU,85,GEORGIATECH,79,164
1159,1987,TEMPLE,75,SOUTHERN-B.R.,56,131
1160,1987,GEORGETOWN,75,BUCKNELL,53,128
1161,1987,OHIOSTATE,91,KENTUCKY,77,168
1162,1987,KANSAS,66,HOUSTON,55,121
1163,1987,SWMISSOURISTATE,65,CLEMSON,60,125
1164,1987,PROVIDENCE,90,ALABAMA-BIRMINGHAM,68,158
1165,1987,AUSTINPEAY,68,ILLINOIS,67,135
1166,1987,NEWORLEANS,83,BRIGHAMYOUNG,79,162
1167,1987,ALABAMA,88,NORTHCAROLINAA&T,71,159
1168,1987,NORTHCAROLINA,113,PENNSYLVANIA,82,195
1169,1987,MICHIGAN,97,NAVY,82,179
1170,1987,NOTREDAME,84,M.TENNESSEESTATE,71,155
1171,1987,TCU,76,MARSHALL,70,146
1172,1987,FLORIDA,82,N.CAROLINASTATE,70,152
1173,1987,PURDUE,104,NORTHEASTERN,95,199
1174,1987,WESTERNKENTUCKY,64,WESTVIRGINIA,62,126
1175,1987,SYRACUSE,79,GEORGIASOUTHERN,73,152
1176,1987,UNLV,80,KANSASSTATE,61,141
1177,1987,WYOMING,78,UCLA,68,146
1178,1987,OKLAHOMA,96,PITTSBURGH,93,189
1179,1987,IOWA,84,TEXAS-ELPASO,82,166
1180,1987,INDIANA,107,AUBURN,90,197
1181,1987,DUKE,65,XAVIER(OHIO),60,125
1182,1987,DEPAUL,83,ST.JOHN'S,75,158
1183,1987,LSU,72,TEMPLE,62,134
1184,1987,GEORGETOWN,82,OHIOSTATE,79,161
1185,1987,KANSAS,67,SWMISSOURISTATE,63,130
1186,1987,PROVIDENCE,90,AUSTINPEAY,87,177
1187,1987,ALABAMA,101,NEWORLEANS,76,177
1188,1987,NORTHCAROLINA,109,MICHIGAN,97,206
1189,1987,NOTREDAME,58,TCU,57,115
1190,1987,FLORIDA,85,PURDUE,66,151
1191,1987,SYRACUSE,104,WESTERNKENTUCKY,86,190
1192,1987,UNLV,92,WYOMING,78,170
1193,1987,IOWA,93,OKLAHOMA,91,184
1194,1987,INDIANA,88,DUKE,82,170
1195,1987,LSU,63,DEPAUL,58,121
1196,1987,GEORGETOWN,70,KANSAS,57,127
1197,1987,PROVIDENCE,103,ALABAMA,82,185
1198,1987,NORTHCAROLINA,74,NOTREDAME,68,142
1199,1987,SYRACUSE,87,FLORIDA,81,168
1200,1987,UNLV,84,IOWA,81,165
1201,1987,INDIANA,77,LSU,76,153
1202,1987,PROVIDENCE,88,GEORGETOWN,73,161
1203,1987,SYRACUSE,79,NORTHCAROLINA,75,154
1204,1987,INDIANA,97,UNLV,93,190
1205,1987,SYRACUSE,77,PROVIDENCE,63,140
1206,1987,INDIANA,74,SYRACUSE,73,147
1207,1988,PURDUE,94,FAIRLEIGHDICKINSON,79,173
1208,1988,MEMPHISSTATE,75,BAYLOR,60,135
1209,1988,DEPAUL,83,WICHITASTATE,62,145
1210,1988,KANSASSTATE,66,LASALLE,53,119
1211,1988,KANSAS,85,XAVIER(OHIO),72,157
1212,1988,MURRAYSTATE,78,N.CAROLINASTATE,75,153
1213,1988,VANDERBILT,80,UTAHSTATE,77,157
1214,1988,PITTSBURGH,108,EASTERNMICHIGAN,90,198
1215,1988,TEMPLE,87,LEHIGH,73,160
1216,1988,GEORGETOWN,66,LSU,63,129
1217,1988,GEORGIATECH,90,IOWASTATE,78,168
1218,1988,RICHMOND,72,INDIANA,69,141
1219,1988,RHODEISLAND,87,MISSOURI,80,167
1220,1988,SYRACUSE,69,NORTHCAROLINAA&T,55,124
1221,1988,SMU,83,NOTREDAME,75,158
1222,1988,DUKE,85,BOSTONUNIVERSITY,69,154
1223,1988,ARIZONA,90,CORNELL,50,140
1224,1988,SETONHALL,80,TEXAS-ELPASO,64,144
1225,1988,IOWA,102,FLORIDASTATE,98,200
1226,1988,UNLV,54,SWMISSOURISTATE,50,104
1227,1988,FLORIDA,62,ST.JOHN'S,59,121
1228,1988,MICHIGAN,63,BOISESTATE,58,121
1229,1988,LOYOLA-MARYMOUNT,119,WYOMING,115,234
1230,1988,NORTHCAROLINA,83,NORTHTEXASSTATE,65,148
1231,1988,OKLAHOMA,94,TENNESSEE-CHAT,66,160
1232,1988,AUBURN,90,BRADLEY,86,176
1233,1988,LOUISVILLE,70,OREGONSTATE,61,131
1234,1988,BRIGHAMYOUNG,98,N.C.-CHARLOTTE,92,190
1235,1988,VILLANOVA,82,ARKANSAS,74,156
1236,1988,ILLINOIS,81,TEXAS-SANANTONIO,72,153
1237,1988,MARYLAND,92,UC-SANTABARBARA,82,174
1238,1988,KENTUCKY,99,SOUTHERN-B.R.,84,183
1239,1988,PURDUE,100,MEMPHISSTATE,73,173
1240,1988,KANSASSTATE,66,DEPAUL,58,124
1241,1988,KANSAS,61,MURRAYSTATE,58,119
1242,1988,VANDERBILT,80,PITTSBURGH,74,154
1243,1988,TEMPLE,74,GEORGETOWN,53,127
1244,1988,RICHMOND,59,GEORGIATECH,55,114
1245,1988,RHODEISLAND,97,SYRACUSE,94,191
1246,1988,DUKE,94,SMU,79,173
1247,1988,ARIZONA,84,SETONHALL,55,139
1248,1988,IOWA,104,UNLV,86,190
1249,1988,MICHIGAN,108,FLORIDA,85,193
1250,1988,NORTHCAROLINA,123,LOYOLA-MARYMOUNT,97,220
1251,1988,OKLAHOMA,107,AUBURN,87,194
1252,1988,LOUISVILLE,97,BRIGHAMYOUNG,76,173
1253,1988,VILLANOVA,66,ILLINOIS,63,129
1254,1988,KENTUCKY,90,MARYLAND,81,171
1255,1988,KANSASSTATE,73,PURDUE,70,143
1256,1988,KANSAS,77,VANDERBILT,64,141
1257,1988,TEMPLE,69,RICHMOND,47,116
1258,1988,DUKE,73,RHODEISLAND,72,145
1259,1988,ARIZONA,99,IOWA,79,178
1260,1988,NORTHCAROLINA,78,MICHIGAN,69,147
1261,1988,OKLAHOMA,108,LOUISVILLE,98,206
1262,1988,VILLANOVA,80,KENTUCKY,74,154
1263,1988,KANSAS,71,KANSASSTATE,58,129
1264,1988,DUKE,63,TEMPLE,53,116
1265,1988,ARIZONA,70,NORTHCAROLINA,52,122
1266,1988,OKLAHOMA,78,VILLANOVA,59,137
1267,1988,KANSAS,66,DUKE,59,125
1268,1988,OKLAHOMA,86,ARIZONA,78,164
1269,1988,KANSAS,83,OKLAHOMA,79,162
1270,1989,ILLINOIS,77,MCNEESESTATE,71,148
1271,1989,BALLSTATE,68,PITTSBURGH,64,132
1272,1989,ARKANSAS,120,LOYOLA-MARYMOUNT,101,221
1273,1989,LOUISVILLE,76,ARKANSAS-L.R.,71,147
1274,1989,TEXAS,76,GEORGIATECH,70,146
1275,1989,MISSOURI,85,CREIGHTON,69,154
1276,1989,COLORADOSTATE,68,FLORIDA,46,114
1277,1989,SYRACUSE,104,BUCKNELL,81,185
1278,1989,OKLAHOMA,72,E.TENNESSEESTATE,71,143
1279,1989,LOUISIANATECH,88,LASALLE,74,162
1280,1989,VIRGINIA,100,PROVIDENCE,97,197
1281,1989,M.TENNESSEESTATE,97,FLORIDASTATE,83,180
1282,1989,SOUTHALABAMA,86,ALABAMA,84,170
1283,1989,MICHIGAN,92,XAVIER(OHIO),87,179
1284,1989,UCLA,84,IOWASTATE,74,158
1285,1989,NORTHCAROLINA,93,SOUTHERN-B.R.,79,172
1286,1989,GEORGETOWN,50,PRINCETON,49,99
1287,1989,NOTREDAME,81,VANDERBILT,65,146
1288,1989,N.CAROLINASTATE,81,SOUTHCAROLINA,66,147
1289,1989,IOWA,87,RUTGERS,73,160
1290,1989,MINNESOTA,86,KANSASSTATE,75,161
1291,1989,SIENA,80,STANFORD,78,158
1292,1989,WESTVIRGINIA,84,TENNESSEE,68,152
1293,1989,DUKE,90,S.CAROLINASTATE,69,159
1294,1989,ARIZONA,94,ROBERTMORRIS,60,154
1295,1989,CLEMSON,83,ST.MARY'S,70,153
1296,1989,DEPAUL,66,MEMPHISSTATE,63,129
1297,1989,UNLV,68,IDAHO,56,124
1298,1989,EVANSVILLE,94,OREGONSTATE,90,184
1299,1989,SETONHALL,60,SWMISSOURISTATE,51,111
1300,1989,TEXAS-ELPASO,85,LSU,74,159
1301,1989,INDIANA,99,GEORGEMASON,85,184
1302,1989,ILLINOIS,72,BALLSTATE,60,132
1303,1989,LOUISVILLE,93,ARKANSAS,84,177
1304,1989,MISSOURI,108,TEXAS,89,197
1305,1989,SYRACUSE,65,COLORADOSTATE,50,115
1306,1989,OKLAHOMA,124,LOUISIANATECH,81,205
1307,1989,VIRGINIA,104,M.TENNESSEESTATE,88,192
1308,1989,MICHIGAN,91,SOUTHALABAMA,82,173
1309,1989,NORTHCAROLINA,88,UCLA,81,169
1310,1989,GEORGETOWN,81,NOTREDAME,74,155
1311,1989,N.CAROLINASTATE,102,IOWA,96,198
1312,1989,MINNESOTA,80,SIENA,67,147
1313,1989,DUKE,70,WESTVIRGINIA,63,133
1314,1989,ARIZONA,94,CLEMSON,68,162
1315,1989,UNLV,85,DEPAUL,70,155
1316,1989,SETONHALL,87,EVANSVILLE,73,160
1317,1989,INDIANA,92,TEXAS-ELPASO,69,161
1318,1989,ILLINOIS,83,LOUISVILLE,69,152
1319,1989,SYRACUSE,83,MISSOURI,80,163
1320,1989,VIRGINIA,86,OKLAHOMA,80,166
1321,1989,MICHIGAN,92,NORTHCAROLINA,87,179
1322,1989,GEORGETOWN,69,N.CAROLINASTATE,61,130
1323,1989,DUKE,87,MINNESOTA,70,157
1324,1989,UNLV,68,ARIZONA,67,135
1325,1989,SETONHALL,78,INDIANA,65,143
1326,1989,ILLINOIS,89,SYRACUSE,86,175
1327,1989,MICHIGAN,102,VIRGINIA,65,167
1328,1989,DUKE,85,GEORGETOWN,77,162
1329,1989,SETONHALL,84,UNLV,61,145
1330,1989,MICHIGAN,83,ILLINOIS,81,164
1331,1989,SETONHALL,95,DUKE,78,173
1332,1989,MICHIGAN,80,SETONHALL,79,159
1333,1990,MICHIGANSTATE,75,MURRAYSTATE,71,146
1334,1990,UC-SANTABARBARA,70,HOUSTON,66,136
1335,1990,LSU,70,VILLANOVA,63,133
1336,1990,MINNESOTA,64,TEXAS-ELPASO,61,125
1337,1990,NORTHERNIOWA,74,MISSOURI,71,145
1338,1990,VIRGINIA,75,NOTREDAME,67,142
1339,1990,SYRACUSE,70,COPPINSTATE,48,118
1340,1990,UNLV,102,ARKANSAS-L.R.,72,174
1341,1990,OHIOSTATE,84,PROVIDENCE,83,167
1342,1990,BALLSTATE,54,OREGONSTATE,53,107
1343,1990,IDAHO,89,LOUISVILLE,78,167
1344,1990,LOYOLA-MARYMOUNT,111,NEWMEXICOSTATE,92,203
1345,1990,MICHIGAN,76,ILLINOISSTATE,70,146
1346,1990,ALABAMA,71,COLORADOSTATE,54,125
1347,1990,ARIZONA,79,SOUTHFLORIDA,67,146
1348,1990,CONNECTICUT,76,BOSTONUNIVERSITY,52,128
1349,1990,CALIFORNIA,65,INDIANA,63,128
1350,1990,CLEMSON,49,BRIGHAMYOUNG,47,96
1351,1990,LASALLE,79,SOUTHERNMISS,63,142
1352,1990,ST.JOHN'S,81,TEMPLE,65,146
1353,1990,DUKE,81,RICHMOND,46,127
1354,1990,UCLA,68,ALABAMA-BIRMINGHAM,56,124
1355,1990,KANSAS,79,ROBERTMORRIS,71,150
1356,1990,OKLAHOMA,77,TOWSONSTATE,68,145
1357,1990,NORTHCAROLINA,83,SWMISSOURISTATE,70,153
1358,1990,DAYTON,88,ILLINOIS,86,174
1359,1990,ARKANSAS,68,PRINCETON,64,132
1360,1990,XAVIER,87,KANSASSTATE,79,166
1361,1990,GEORGETOWN,70,TEXASSOUTHERN,52,122
1362,1990,TEXAS,100,GEORGIA,88,188
1363,1990,PURDUE,75,NELOUISIANA,63,138
1364,1990,MICHIGANSTATE,62,UC-SANTABARBARA,58,120
1365,1990,GEORGIATECH,94,LSU,91,185
1366,1990,MINNESOTA,81,NORTHERNIOWA,78,159
1367,1990,SYRACUSE,63,VIRGINIA,61,124
1368,1990,UNLV,76,OHIOSTATE,65,141
1369,1990,BALLSTATE,62,LOUISVILLE,60,122
1370,1990,LOYOLA-MARYMOUNT,149,MICHIGAN,115,264
1371,1990,ALABAMA,77,ARIZONA,55,132
1372,1990,CONNECTICUT,74,CALIFORNIA,54,128
1373,1990,CLEMSON,79,LASALLE,75,154
1374,1990,DUKE,76,ST.JOHN'S,72,148
1375,1990,UCLA,71,KANSAS,70,141
1376,1990,NORTHCAROLINA,79,OKLAHOMA,77,156
1377,1990,ARKANSAS,86,DAYTON,84,170
1378,1990,XAVIER,74,GEORGETOWN,71,145
1379,1990,TEXAS,73,PURDUE,72,145
1380,1990,GEORGIATECH,81,MICHIGANSTATE,80,161
1381,1990,MINNESOTA,82,SYRACUSE,75,157
1382,1990,UNLV,69,BALLSTATE,67,136
1383,1990,LOYOLA-MARYMOUNT,62,ALABAMA,60,122
1384,1990,CONNECTICUT,71,CLEMSON,70,141
1385,1990,DUKE,90,UCLA,81,171
1386,1990,ARKANSAS,96,NORTHCAROLINA,73,169
1387,1990,TEXAS,102,XAVIER,89,191
1388,1990,GEORGIATECH,93,MINNESOTA,91,184
1389,1990,UNLV,131,LOYOLA-MARYMOUNT,101,232
1390,1990,DUKE,79,CONNECTICUT,78,157
1391,1990,ARKANSAS,88,TEXAS,85,173
1392,1990,UNLV,90,GEORGIATECH,81,171
1393,1990,DUKE,97,ARKANSAS,83,180
1394,1990,UNLV,103,DUKE,73,176
1395,1991,UNLV,99,MONTANA,65,164
1396,1991,GEORGETOWN,79,VANDERBILT,60,139
1397,1991,MICHIGANSTATE,60,WISCONSIN-GREENBAY,58,118
1398,1991,UTAH,82,SOUTHALABAMA,72,154
1399,1991,CREIGHTON,64,NEWMEXICOSTATE,56,120
1400,1991,SETONHALL,71,PEPPERDINE,51,122
1401,1991,BRIGHAMYOUNG,61,VIRGINIA,48,109
1402,1991,ARIZONA,93,ST.FRANCIS-PA,80,173
1403,1991,OHIOSTATE,97,TOWSONSTATE,86,183
1404,1991,GEORGIATECH,87,DEPAUL,70,157
1405,1991,TEXAS,73,ST.PETER'S,65,138
1406,1991,ST.JOHN'S,75,NORTHERNILLINOIS,68,143
1407,1991,CONNECTICUT,79,LSU,62,141
1408,1991,XAVIER-OHIO,89,NEBRASKA,84,173
1409,1991,IOWA,76,E.TENNESSEESTATE,73,149
1410,1991,DUKE,102,NELOUISIANA,73,175
1411,1991,NORTHCAROLINA,101,NORTHEASTERN,66,167
1412,1991,VILLANOVA,50,PRINCETON,48,98
1413,1991,EASTERNMICHIGAN,76,MISSISSIPPISTATE,56,132
1414,1991,PENNSTATE,74,UCLA,69,143
1415,1991,N.CAROLINASTATE,114,SOUTHERNMISS,85,199
1416,1991,OKLAHOMASTATE,67,NEWMEXICO,54,121
1417,1991,TEMPLE,80,PURDUE,63,143
1418,1991,RICHMOND,73,SYRACUSE,69,142
1419,1991,ARKANSAS,117,GEORGIASTATE,76,193
1420,1991,ARIZONASTATE,79,RUTGERS,76,155
1421,1991,WAKEFOREST,71,LOUISIANATECH,65,136
1422,1991,ALABAMA,89,MURRAYSTATE,79,168
1423,1991,PITTSBURGH,76,GEORGIA,68,144
1424,1991,KANSAS,55,NEWORLEANS,49,104
1425,1991,FLORIDASTATE,75,SOUTHERNCALIFORNIA,72,147
1426,1991,INDIANA,79,COASTALCAROLINA,69,148
1427,1991,UNLV,62,GEORGETOWN,54,116
1428,1991,UTAH,85,MICHIGANSTATE,84,169
1429,1991,SETONHALL,81,CREIGHTON,69,150
1430,1991,ARIZONA,76,BRIGHAMYOUNG,61,137
1431,1991,OHIOSTATE,65,GEORGIATECH,61,126
1432,1991,ST.JOHN'S,84,TEXAS,76,160
1433,1991,CONNECTICUT,66,XAVIER-OHIO,50,116
1434,1991,DUKE,85,IOWA,70,155
1435,1991,NORTHCAROLINA,84,VILLANOVA,69,153
1436,1991,EASTERNMICHIGAN,71,PENNSTATE,68,139
1437,1991,OKLAHOMASTATE,73,N.CAROLINASTATE,64,137
1438,1991,TEMPLE,77,RICHMOND,64,141
1439,1991,ARKANSAS,97,ARIZONASTATE,90,187
1440,1991,ALABAMA,96,WAKEFOREST,88,184
1441,1991,KANSAS,77,PITTSBURGH,66,143
1442,1991,INDIANA,82,FLORIDASTATE,60,142
1443,1991,UNLV,83,UTAH,66,149
1444,1991,SETONHALL,81,ARIZONA,77,158
1445,1991,ST.JOHN'S,91,OHIOSTATE,74,165
1446,1991,DUKE,81,CONNECTICUT,67,148
1447,1991,NORTHCAROLINA,93,EASTERNMICHIGAN,67,160
1448,1991,TEMPLE,72,OKLAHOMASTATE,63,135
1449,1991,ARKANSAS,93,ALABAMA,70,163
1450,1991,KANSAS,83,INDIANA,65,148
1451,1991,UNLV,77,SETONHALL,65,142
1452,1991,DUKE,78,ST.JOHN'S,61,139
1453,1991,NORTHCAROLINA,75,TEMPLE,72,147
1454,1991,KANSAS,93,ARKANSAS,81,174
1455,1991,DUKE,79,UNLV,77,156
1456,1991,KANSAS,79,NORTHCAROLINA,73,152
1457,1991,DUKE,72,KANSAS,65,137
1458,1992,KANSAS,100,HOWARD,67,167
1459,1992,TEXAS-ELPASO,55,EVANSVILLE,50,105
1460,1992,MICHIGANSTATE,61,SWMISSOURISTATE,54,115
1461,1992,CINCINNATI,85,DELAWARE,47,132
1462,1992,MEMPHISSTATE,80,PEPPERDINE,70,150
1463,1992,ARKANSAS,80,MURRAYSTATE,69,149
1464,1992,GEORGIATECH,65,HOUSTON,60,125
1465,1992,SOUTHERNCALIFORNIA,84,NELOUISIANA,54,138
1466,1992,OHIOSTATE,83,MISS.VALLEYSTATE,56,139
1467,1992,CONNECTICUT,86,NEBRASKA,65,151
1468,1992,ALABAMA,80,STANFORD,75,155
1469,1992,NORTHCAROLINA,68,MIAMI(OHIO),63,131
1470,1992,MICHIGAN,73,TEMPLE,66,139
1471,1992,E.TENNESSEESTATE,87,ARIZONA,80,167
1472,1992,TULANE,61,ST.JOHN'S,57,118
1473,1992,OKLAHOMASTATE,100,GEORGIASOUTHERN,73,173
1474,1992,DUKE,82,CAMPBELL,56,138
1475,1992,IOWA,98,TEXAS,92,190
1476,1992,MISSOURI,89,WESTVIRGINIA,78,167
1477,1992,SETONHALL,78,LASALLE,76,154
1478,1992,SYRACUSE,51,PRINCETON,43,94
1479,1992,MASSACHUSETTS,85,FORDHAM,58,143
1480,1992,IOWASTATE,76,N.C.-CHARLOTTE,74,150
1481,1992,KENTUCKY,88,OLDDOMINION,69,157
1482,1992,UCLA,73,ROBERTMORRIS,53,126
1483,1992,LOUISVILLE,81,WAKEFOREST,58,139
1484,1992,NEWMEXICOSTATE,81,DEPAUL,73,154
1485,1992,SWLOUISIANA,87,OKLAHOMA,83,170
1486,1992,GEORGETOWN,75,SOUTHFLORIDA,60,135
1487,1992,FLORIDASTATE,78,MONTANA,68,146
1488,1992,LSU,94,BRIGHAMYOUNG,83,177
1489,1992,INDIANA,94,EASTERNILLINOIS,55,149
1490,1992,TEXAS-ELPASO,66,KANSAS,60,126
1491,1992,CINCINNATI,77,MICHIGANSTATE,65,142
1492,1992,MEMPHISSTATE,82,ARKANSAS,80,162
1493,1992,GEORGIATECH,79,SOUTHERNCALIFORNIA,78,157
1494,1992,OHIOSTATE,78,CONNECTICUT,55,133
1495,1992,NORTHCAROLINA,64,ALABAMA,55,119
1496,1992,MICHIGAN,102,E.TENNESSEESTATE,90,192
1497,1992,OKLAHOMASTATE,87,TULANE,71,158
1498,1992,DUKE,75,IOWA,62,137
1499,1992,SETONHALL,88,MISSOURI,71,159
1500,1992,MASSACHUSETTS,77,SYRACUSE,71,148
1501,1992,KENTUCKY,106,IOWASTATE,98,204
1502,1992,UCLA,85,LOUISVILLE,69,154
1503,1992,NEWMEXICOSTATE,81,SWLOUISIANA,73,154
1504,1992,FLORIDASTATE,78,GEORGETOWN,68,146
1505,1992,INDIANA,89,LSU,79,168
1506,1992,CINCINNATI,69,TEXAS-ELPASO,67,136
1507,1992,MEMPHISSTATE,83,GEORGIATECH,79,162
1508,1992,OHIOSTATE,80,NORTHCAROLINA,73,153
1509,1992,MICHIGAN,75,OKLAHOMASTATE,72,147
1510,1992,DUKE,81,SETONHALL,69,150
1511,1992,KENTUCKY,87,MASSACHUSETTS,77,164
1512,1992,UCLA,85,NEWMEXICOSTATE,78,163
1513,1992,INDIANA,85,FLORIDASTATE,74,159
1514,1992,CINCINNATI,88,MEMPHISSTATE,57,145
1515,1992,MICHIGAN,75,OHIOSTATE,71,146
1516,1992,DUKE,104,KENTUCKY,103,207
1517,1992,INDIANA,106,UCLA,79,185
1518,1992,MICHIGAN,76,CINCINNATI,72,148
1519,1992,DUKE,81,INDIANA,78,159
1520,1992,DUKE,71,MICHIGAN,51,122
1521,1993,KENTUCKY,96,RIDER,52,148
1522,1993,UTAH,86,PITTSBURGH,65,151
1523,1993,WAKEFOREST,81,TENNESSEE-CHAT,58,139
1524,1993,IOWA,82,NELOUISIANA,69,151
1525,1993,TULANE,55,KANSASSTATE,53,108
1526,1993,FLORIDASTATE,82,EVANSVILLE,70,152
1527,1993,WESTERNKENTUCKY,55,MEMPHISSTATE,52,107
1528,1993,SETONHALL,81,TENNESSEESTATE,59,140
1529,1993,MICHIGAN,84,COASTALCAROLINA,53,137
1530,1993,UCLA,81,IOWASTATE,70,151
1531,1993,GEORGEWASHINGTON,82,NEWMEXICO,68,150
1532,1993,SOUTHERN,93,GEORGIATECH,78,171
1533,1993,ILLINOIS,75,LONGBEACHSTATE,72,147
1534,1993,VANDERBILT,92,BOISESTATE,72,164
1535,1993,TEMPLE,75,MISSOURI,61,136
1536,1993,SANTACLARA,64,ARIZONA,61,125
1537,1993,NORTHCAROLINA,85,EASTCAROLINA,65,150
1538,1993,RHODEISLAND,74,PURDUE,68,142
1539,1993,ST.JOHN'S,85,TEXASTECH,67,152
1540,1993,ARKANSAS,94,HOLYCROSS,64,158
1541,1993,VIRGINIA,78,MANHATTAN,66,144
1542,1993,MASSACHUSETTS,54,PENNSYLVANIA,50,104
1543,1993,NEWMEXICOSTATE,93,NEBRASKA,79,172
1544,1993,CINCINNATI,93,COPPINSTATE,66,159
1545,1993,INDIANA,97,WRIGHTSTATE,54,151
1546,1993,XAVIER(OHIO),73,NEWORLEANS,55,128
1547,1993,OKLAHOMASTATE,74,MARQUETTE,62,136
1548,1993,LOUISVILLE,76,DELAWARE,70,146
1549,1993,CALIFORNIA,66,LSU,64,130
1550,1993,DUKE,105,SOUTHERNILLINOIS,70,175
1551,1993,BRIGHAMYOUNG,80,SMU,71,151
1552,1993,KANSAS,94,BALLSTATE,72,166
1553,1993,KENTUCKY,83,UTAH,62,145
1554,1993,WAKEFOREST,84,IOWA,78,162
1555,1993,FLORIDASTATE,94,TULANE,63,157
1556,1993,WESTERNKENTUCKY,72,SETONHALL,68,140
1557,1993,MICHIGAN,86,UCLA,84,170
1558,1993,GEORGEWASHINGTON,90,SOUTHERN,80,170
1559,1993,VANDERBILT,85,ILLINOIS,68,153
1560,1993,TEMPLE,68,SANTACLARA,57,125
1561,1993,NORTHCAROLINA,112,RHODEISLAND,67,179
1562,1993,ARKANSAS,80,ST.JOHN'S,74,154
1563,1993,VIRGINIA,71,MASSACHUSETTS,56,127
1564,1993,CINCINNATI,92,NEWMEXICOSTATE,55,147
1565,1993,INDIANA,73,XAVIER(OHIO),55,128
1566,1993,LOUISVILLE,78,OKLAHOMASTATE,63,141
1567,1993,CALIFORNIA,82,DUKE,77,159
1568,1993,KANSAS,90,BRIGHAMYOUNG,76,166
1569,1993,KENTUCKY,103,WAKEFOREST,69,172
1570,1993,FLORIDASTATE,81,WESTERNKENTUCKY,78,159
1571,1993,MICHIGAN,72,GEORGEWASHINGTON,64,136
1572,1993,TEMPLE,67,VANDERBILT,59,126
1573,1993,NORTHCAROLINA,80,ARKANSAS,74,154
1574,1993,CINCINNATI,71,VIRGINIA,54,125
1575,1993,INDIANA,82,LOUISVILLE,69,151
1576,1993,KANSAS,93,CALIFORNIA,76,169
1577,1993,KENTUCKY,106,FLORIDASTATE,81,187
1578,1993,MICHIGAN,77,TEMPLE,72,149
1579,1993,NORTHCAROLINA,75,CINCINNATI,68,143
1580,1993,KANSAS,83,INDIANA,77,160
1581,1993,MICHIGAN,81,KENTUCKY,78,159
1582,1993,NORTHCAROLINA,78,KANSAS,68,146
1583,1993,NORTHCAROLINA,77,MICHIGAN,71,148
1584,1994,CONNECTICUT,64,RIDER,46,110
1585,1994,GEORGEWASHINGTON,51,ALABAMA-BIRMINGHAM,46,97
1586,1994,PENNSYLVANIA,90,NEBRASKA,80,170
1587,1994,FLORIDA,64,JAMESMADISON,62,126
1588,1994,NORTHCAROLINA,71,LIBERTY,51,122
1589,1994,BOSTONCOLLEGE,67,WASHINGTONSTATE,64,131
1590,1994,TEMPLE,61,DREXEL,39,100
1591,1994,INDIANA,84,OHIO,72,156
1592,1994,WAKEFOREST,68,COLLEGECHARLESTON,58,126
1593,1994,KANSAS,102,TENNESSEE-CHAT,73,175
1594,1994,PURDUE,98,CENTRALFLORIDA,67,165
1595,1994,ALABAMA,76,PROVIDENCE,70,146
1596,1994,MARQUETTE,81,SWLOUISIANA,59,140
1597,1994,KENTUCKY,83,TENNESSEESTATE,70,153
1598,1994,DUKE,82,TEXASSOUTHERN,70,152
1599,1994,MICHIGANSTATE,84,SETONHALL,73,157
1600,1994,MARYLAND,74,ST.LOUIS,66,140
1601,1994,MASSACHUSETTS,78,SWTEXASSTATE,60,138
1602,1994,MICHIGAN,78,PEPPERDINE,74,152
1603,1994,TEXAS,91,WESTERNKENTUCKY,77,168
1604,1994,OKLAHOMASTATE,65,NEWMEXICOSTATE,55,120
1605,1994,TULSA,112,UCLA,102,214
1606,1994,GEORGETOWN,84,ILLINOIS,77,161
1607,1994,ARKANSAS,94,NORTHCAROLINAA&T,79,173
1608,1994,SYRACUSE,92,HAWAII,78,170
1609,1994,WISCONSIN-GB,61,CALIFORNIA,57,118
1610,1994,MISSOURI,76,NAVY,53,129
1611,1994,WISCONSIN,80,CINCINNATI,72,152
1612,1994,VIRGINIA,57,NEWMEXICO,54,111
1613,1994,ARIZONA,81,LOYOLA-MARYLAND,55,136
1614,1994,LOUISVILLE,67,BOISESTATE,58,125
1615,1994,MINNESOTA,74,SOUTHERNILLINOIS,60,134
1616,1994,CONNECTICUT,75,GEORGEWASHINGTON,63,138
1617,1994,FLORIDA,70,PENNSYLVANIA,58,128
1618,1994,INDIANA,67,TEMPLE,58,125
1619,1994,BOSTONCOLLEGE,75,NORTHCAROLINA,72,147
1620,1994,PURDUE,83,ALABAMA,73,156
1621,1994,KANSAS,69,WAKEFOREST,58,127
1622,1994,MARQUETTE,75,KENTUCKY,63,138
1623,1994,DUKE,85,MICHIGANSTATE,74,159
1624,1994,MARYLAND,95,MASSACHUSETTS,87,182
1625,1994,MICHIGAN,84,TEXAS,79,163
1626,1994,TULSA,82,OKLAHOMASTATE,80,162
1627,1994,ARKANSAS,85,GEORGETOWN,73,158
1628,1994,SYRACUSE,64,WISCONSIN-GB,59,123
1629,1994,MISSOURI,109,WISCONSIN,96,205
1630,1994,ARIZONA,71,VIRGINIA,58,129
1631,1994,LOUISVILLE,60,MINNESOTA,55,115
1632,1994,BOSTONCOLLEGE,77,INDIANA,68,145
1633,1994,FLORIDA,69,CONNECTICUT,60,129
1634,1994,DUKE,59,MARQUETTE,49,108
1635,1994,PURDUE,83,KANSAS,78,161
1636,1994,ARKANSAS,103,TULSA,84,187
1637,1994,MICHIGAN,78,MARYLAND,71,149
1638,1994,MISSOURI,98,SYRACUSE,88,186
1639,1994,ARIZONA,82,LOUISVILLE,70,152
1640,1994,FLORIDA,74,BOSTONCOLLEGE,66,140
1641,1994,DUKE,69,PURDUE,60,129
1642,1994,ARKANSAS,76,MICHIGAN,68,144
1643,1994,ARIZONA,92,MISSOURI,72,164
1644,1994,DUKE,70,FLORIDA,65,135
1645,1994,ARKANSAS,91,ARIZONA,82,173
1646,1994,ARKANSAS,76,DUKE,72,148
1647,1995,WAKEFOREST,79,NORTHCAROLINAA&T,47,126
1648,1995,ST.LOUIS,64,MINNESOTA,61,125
1649,1995,ALABAMA,91,PENNSYLVANIA,85,176
1650,1995,OKLAHOMASTATE,73,DREXEL,49,122
1651,1995,STANFORD,70,NC-CHARLOTTE,68,138
1652,1995,MASSACHUSETTS,68,ST.PETER'S,51,119
1653,1995,OLDDOMINION,89,VILLANOVA,81,170
1654,1995,TULSA,68,ILLINOIS,62,130
1655,1995,MANHATTAN,77,OKLAHOMA,67,144
1656,1995,ARIZONASTATE,81,BALLSTATE,66,147
1657,1995,KENTUCKY,113,MOUNTST.MARY'S,67,180
1658,1995,TULANE,76,BRIGHAMYOUNG,70,146
1659,1995,IOWASTATE,64,FLORIDA,61,125
1660,1995,NORTHCAROLINA,80,MURRAYSTATE,70,150
1661,1995,WEBERSTATE,79,MICHIGANSTATE,72,151
1662,1995,GEORGETOWN,68,XAVIER(OHIO),63,131
1663,1995,MIAMI(OHIO),71,ARIZONA,62,133
1664,1995,VIRGINIA,96,NICHOLLSSTATE,72,168
1665,1995,KANSAS,82,COLGATE,68,150
1666,1995,WESTERNKENTUCKY,82,MICHIGAN,76,158
1667,1995,SYRACUSE,96,SOUTHERNILLINOIS,92,188
1668,1995,ARKANSAS,79,TEXASSOUTHERN,78,157
1669,1995,MEMPHIS,77,LOUISVILLE,56,133
1670,1995,PURDUE,49,WISCONSIN-GB,48,97
1671,1995,CONNECTICUT,100,TENNESSEE-CHAT,71,171
1672,1995,CINCINNATI,77,TEMPLE,71,148
1673,1995,TEXAS,90,OREGON,73,163
1674,1995,MARYLAND,87,GONZAGA,63,150
1675,1995,OKLAHOMASTATE,66,ALABAMA,52,118
1676,1995,WAKEFOREST,64,ST.LOUIS,59,123
1677,1995,MASSACHUSETTS,75,STANFORD,53,128
1678,1995,TULSA,64,OLDDOMINION,52,116
1679,1995,ARIZONASTATE,64,MANHATTAN,54,118
1680,1995,KENTUCKY,82,TULANE,60,142
1681,1995,GEORGETOWN,53,WEBERSTATE,51,104
1682,1995,NORTHCAROLINA,73,IOWASTATE,51,124
1683,1995,VIRGINIA,60,MIAMI(OHIO),54,114
1684,1995,KANSAS,75,WESTERNKENTUCKY,70,145
1685,1995,MEMPHIS,75,PURDUE,73,148
1686,1995,ARKANSAS,96,SYRACUSE,94,190
1687,1995,MISSISSIPPISTATE,78,UTAH,64,142
1688,1995,UCLA,75,MISSOURI,74,149
1689,1995,CONNECTICUT,96,CINCINNATI,91,187
1690,1995,MARYLAND,82,TEXAS,68,150
1691,1995,OKLAHOMASTATE,71,WAKEFOREST,66,137
1692,1995,MASSACHUSETTS,76,TULSA,51,127
1693,1995,NORTHCAROLINA,74,GEORGETOWN,64,138
1694,1995,KENTUCKY,97,ARIZONASTATE,73,170
1695,1995,VIRGINIA,67,KANSAS,58,125
1696,1995,ARKANSAS,96,MEMPHIS,91,187
1697,1995,UCLA,86,MISSISSIPPISTATE,67,153
1698,1995,CONNECTICUT,99,MARYLAND,89,188
1699,1995,OKLAHOMASTATE,68,MASSACHUSETTS,54,122
1700,1995,NORTHCAROLINA,74,KENTUCKY,61,135
1701,1995,ARKANSAS,68,VIRGINIA,61,129
1702,1995,UCLA,102,CONNECTICUT,96,198
1703,1995,UCLA,74,OKLAHOMASTATE,61,135
1704,1995,ARKANSAS,75,NORTHCAROLINA,68,143
1705,1995,UCLA,89,ARKANSAS,78,167
